者	Giả		Tác giả
都	Đô		Đô hội
暑	Thử		Sức nóng
署	Thự		Chức vụ
奢	Xa		Xa hoa
賭	Đổ		Đánh bạc
諸	Chư		Chư hầu
緒	Tự		Cùng nhau
煮	Chử		Đun nấu
著	Trứ		Trứ danh
箸	Trứ		Đôi đũa
敕	Sắc		Sắc lệnh
整	Chỉnh	Chỉnh đốn
征	Chinh	Chinh phục
証	Chứng	Chứng minh
症	Chứng	Triệu chứng
主	Chủ		Ông chủ
注	Chú		Chú ý
住	Trú		Cư trú
柱	Trụ		Trụ cột
駐	Trú		Bãi đậu xe
往	Vãng	Vãng lai
式	Thức	Hình thức
拭	Thức	Lau chùi
試	Thí		Thí nghiệm
武	Vũ		Vũ khí
賦	Phú		Phú quý
賊	Tặc		Hải tặc
川	Xuyên	Sông
州	Châu	Cửu châu
順	Thuận	Thuận lợi
訓	Huấn	Huấn luyện
暖	Noãn	Ấm nóng
緩	Hoãn	Trì hoãn
援	Viện	Viện trợ
媛	Viện	Bà hoàng
受	Thụ		Nhận
授	Thụ		Trao cho
愛	Ái		Tình yêu
曖	Ái		Mập mờ
相	Tương	Tương tự
箱	Tương	Cái hộp
想	Tưởng	Tưởng tượng
霜	Sương	Sương giá
象	Tượng	Con voi
像	Tượng	Tưởng tượng
将	Tương	Tương lai
奨	Tưởng	Học bổng
重	Trọng	Trọng lượng
種	Chủng	Chủng loại
衝	Xung	Xung đột
腫	Thũng	Khối u
宿	Túc		Nhà trọ
縮	Xúc		Co lại
述	Thuật	Thuật lại
術	Thuật	Phép thuật
召	Triệu	Triệu tập
紹	Thiệu	Giới thiệu
昭	Chiêu	Chiêu hòa
招	Chiêu	Chiêu đãi
超	Siêu	Siêu phàm
照	Chiếu	Chiếu sáng
詔	Chiếu	Chiếu chỉ
沼	Chiểu	Đầm, ao
拐	Quải	Bắt cóc
火	Hỏa		Lửa
炎	Viêm	Cháy lớn
談	Đàm		Đàm thoại
淡	Đạm		Thanh đạm
券	Khoán	Chứng khoán
巻	Quyển	Quyển sách
圏	Quyển	Khí quyển
拳	Quyền	Nắm đấm
読	Độc		Đọc
続	Tục		Liên tục		TƠ được BÁN LIÊN TỤC
勝	Thắng	Thắng lợi
藤	Đằng	Hoa tử đằng
騰	Đằng	Tiến lên
謄	Đằng	Sao chép
興	Hưng	Hưng phấn
衆	Chúng	Công chúng
肖	Tiêu	Chân dung			CHÂN DUNG NGUYỆT và 3 quả chuối TIÊU
消	Tiêu	Tiêu trừ, xóa		NƯỚC XÓA nhòa đi bức CHÂN DUNG
宵	Tiêu	Buổi tối
硝	Tiêu	Diêm tiêu
鎖	Tỏa		Tỏa sáng
削	Tước	Gọt
章	Chương	Văn chương
障	Chướng	Chướng ngại
彰	Chương	Rực rỡ
票	Phiếu	Bỏ phiếu
標	Tiêu	Mục tiêu
漂	Phiêu	Phiêu lưu
垂	Thùy	Rủ xuống
睡	Thụy	Ngủ
郵	Bưu		Bưu điện
唾	Thóa	Thóa mạ
乗	Thừa	Lên xe				LÊN XE THỪA ở bên PHÍA ĐÔNG
剰	Thặng	Thặng dư
申	Thân	Xưng tên
伸	Thân	Duỗi thẳng
紳	Thân	Đàn ông
神	Thần	Thần thánh
油	Du		Dầu ăn
宙	Trụ		Vũ trụ
笛	Địch	Cái sáo
袖	Tụ		Ống tay áo
抽	Trừu	Trừu tượng
甲	Giáp	Thiết giáp
押	Áp		Ấn				TAY GIÁP đừng có ẤN
岬	Giáp	Vệ núi
制	Chế		Chế độ
製	Chế		Chế tạo
半	Bán		Một nửa
判	Phán	Phán đoán
伴	Bạn		Bầu bạn
性	Tính	Tính cách
姓	Tính	Họ tên
平	Bình	Hòa bình		2 cái CAN bằng cái BÌNH
評	Bình	Bình luận
坪	Bình	Đơn vị đo
呼	Hô		Hô hấp			MỒM BÌNH đang HÔ HẤP
着	Trước	Mặc				MẮT nhìn CON DÊ MẶC áo TRƯỚC
看	Khán	Khán giả
差	Sai		Sai khác		CON DÊ LÀM VIỆC SAI TRÁI
他	Tha		Người lạ
施	Thi		Thực thi
旅	Lữ		Lữ hành, du lịch
遊	Du		Chơi
族	Tộc		Gia tộc
旋	Toàn	Trở lại
段	Đoạn	Giai đoạn
鍛	Đoán	Rèn luyện
練	Luyện	Luyện tập
錬	Luyện	Tinh luyện
裏	Lý		Mặt trái
打	Đả		Đánh
灯	Đăng	Cái đèn
釘	Đinh	Đinh ốc
訂	Đính	Đính chính
頂	Đỉnh	Đỉnh cao
代	Đại		Thời đại
袋	Đại		Cái túi
貸	Thải	Cho vay			THỜI ĐẠI CHO VAY TIỀN THẢI
賃	Nhâm	Thuê
妊	Nhâm	Mang thai
氏	Thị		Họ tên
婚	Hôn		Hôn nhân
民	Dân		Dân chúng
眠	Miên	Ngủ
底	Để		Cái đáy
低	Đê		Thấp
抵	Đề		Đề kháng
邸	Để		Lâu đài
是	Thị		Thị phi
堤	Đê		Con đê
題	Đề		Vấn đề
提	Đề		Đề án
豆	Đậu		Hạt đậu
登	Đăng	Đăng ký			ĐĂNG KÝ BÁT ĐẬU
澄	Trừng	Làm sạch
短	Đoản	Ngắn
痘	Đậu		Đậu mùa
布	Bố		Vải
怖	Bố		Khủng bố
希	Hi		Hi vọng
我	Ngã		Bản ngã
餓	Ngạ		Đói
投	Đầu		Đầu tư
殺	Sát		Giết
役	Dịch	Chiến dịch
疫	Dịch	Dịch bệnh
設	Thiết	Thiết lập
没	Một		Chìm chết
穀	Cốc		Ngũ cốc
殼	Xác		Giáp xác
殿	Điện	Cung điện
動	Động	Chuyển động
働	Động	Lao động		NGƯỜI ĐỨNG CHUYỂN ĐỘNG là đang LAO ĐỘNG
勲	Huân	Huân chương
薫	Huân	Hương thơm
皮	Bì		Da				Ở SƯỜN NÚI mở CHI NHÁNH bán đồ DA
疲	Bì		Mệt mỏi			BỆNH trên DA là MỆT MỎI
彼	Bỉ		Anh ấy
被	Bị		Bị hại
波	Ba		Con sóng
婆	Bà		Bà già
破	Phá		Phá rách
披	Phi		Vạch ra
掴	Quặc	Nắm, bắt
発	Phát	Phát triển
廃	Phế		Tàn phế
表	Biểu	Phát biểu
俵	Biếu	Biếu
衣	Y		Y phục
依	Ỷ		Ỷ lại
反	Phản	Phản đối
坂	Phản	Cái dốc
返	Phản	Trả lại			PHẢN đối DẪN tới TRẢ LẠI
飯	Phạn	Cơm
阪	Phản	Osaka
板	Bản		Tấm ván
版	Bản		Xuất bản
仮	Giả		Giả thuyết
販	Phiến	Bán
部	Bộ		Bộ phận
倍	Bội		Bội số
陪	Bồi		Bồi thẩm
培	Bồi		Bồi dưỡng
賠	Bồi		Bồi thường
剖	Phẫu	Phẫu thuật
不	Bất		Bất tử
杯	Bôi		Cái chén
否	Phủ		Phủ định
幸	Hạnh	Hạnh phúc
服	Phục	Đồng phục
報	Báo		Báo cáo
非	Phi		Phi thường
悲	Bi		Bi thảm
罪	Tội		Tội phạm
扉	Phi		Cánh cửa
俳	Bài		Nghệ sỹ
排	Bài		Bài trừ
輩	Bối		Tiền bối
背	Bối		Cái lưng
小	Tiểu	Nhỏ
少	Thiểu	Ít
秒	Miểu	Giây
妙	Diệu	Huyền diệu
沙	Sa		Nhỏ bé
劣	Liệt	Yếu kém
砂	Sa		Cát
抄	Sao		Sao chép
炒	Sao		Xào
列	Liệt	Hàng lối
烈	Liệt	Mãnh liệt
例	Lệ		Ví dụ
裂	Liệt	Xé rách
雷	Lôi		Sấm sét
電	Điện	Điện lực
雪	Tuyết	Bông tuyết
雲	Vân		Mây
曇	Đàm		Mây trời
雰	Phân	Bầu không khí
震	Chấn	Địa chấn
霊	Linh	Linh hồn
零	Linh	Số 0
霧	Vụ		Sương mù
霜	Sương	Sương giá
露	Lộ		Sương đêm
需	Nhu		Nhu cầu
銀	Ngân	Ngân hàng
痕	Ngân	Vết sẹo
根	Căn		Gốc rễ
限	Hạn		Giới hạn
恨	Hận		Hận thù
眼	Nhãn	Nhãn cầu
退	Thoái	Rút lui
良	Lương	Tốt
娘	Nương	Con gái
郎	Lang	Con trai
狼	Lang	Chó sói
廊	Lang	Hành lang
朗	Lãng	Chiếu sáng
浪	Lãng	Lãng tử
船	Thuyền	Con thuyền
航	Hàng	Hàng không
艦	Hạm		Chiến hạm
舶	Bạc		Tàu buồm
艇	Đĩnh	Thuyền nhỏ
舷	Huyền	Mạn thuyền
般	Ban		Bình thường
湿	Thấp	Ẩm thấp
顕	Hiển	Hiển nhiên
並	Tịnh	Xếp hàng		XẾP 2 HÀNG dọc 2 hàng ngang hình chữ V
霊	Linh	Linh hồn
普	Phổ		Phổ thông
譜	Phổ		Gia phả
昔	Tích	Ngày xưa
借	Tá		Vay mượn		NGÀY XƯA NGƯỜI đã cho VAY MƯỢN hàng TÁ
散	Tản		Tản bộ
籍	Tịch	Quốc tịch
惜	Tiếc	Hối tiếc
措	Thố		Biện pháp
錯	Thác	Thác loạn
資	Tư		Đầu tư
姿	Tư		Tư thế
諮	Tư		Tư vấn
茨	Tì		Cái gai
恣	Tứ		Phóng túng
羨	Tiện	Ghen tỵ
盗	Đạo		Đạo tặc
福	Phúc	Phúc lợi
幅	Phúc	Bề dày
副	Phó		Phó giám đốc
富	Phú		Phong phú
復	Phục	Phục hồi
腹	Phúc	Cái bụng
複	Phức	Phức tạp
覆	Phúc	Che phủ
履	Lý		Lý lịch
放	Phóng	Giải phóng
倣	Phỏng	Mô phỏng
敷	Phu		Trải lát
激	Khích	Kích thích
傲	Ngạo	Ngạo mạn
洋	Dương	Phương tây
詳	Tường	Chi tiết
鮮	Tiên	Tươi sống
祥	Tường	Cát tường
養	Dưỡng	Dinh dưỡng
路	Lộ		Con đường
賂	Lộ		Hối lộ
露	Lộ		Sương đêm
以	Dĩ		Cái mốc
似	Tự		Giống nhau
胃	Vị		Dạ dày
膚	Phu		Da
帯	Đới		Cái đai
滞	Trệ		Đình trệ
肩	Kiên	Vai
骨	Cốt		Xương
滑	Hoạt	Linh hoạt
眉	Mi		Lông mày
幾	Cơ		Bao nhiêu
機	Cơ		Máy móc
畿	Kì		Kinh kì
極	Cực		Cực đoan
吉	Cát		Vui vẻ
結	Kết		Kết hôn
詰	Cật		Vặn hỏi
喜	Hỉ		Hoan hỉ
嬉	Hi		Vui sướng
樹	Thụ		Cổ thụ
鼓	Cổ		Cái trống
膨	Bành	Bành trướng
舎	Xá		Phố xá
捨	Xả		Vứt
加	Gia		Tham gia
架	Giá		Cái giá
賀	Hạ		Chúc mừng
害	Hại		Tổn hại
割	Cát		Vỡ
轄	Hạt		Cai quản
哀	Ai		Bi ai
衰	Suy		Suy nhược
衷	Trung	Trung thực
井	Tỉnh	Cái giếng
囲	Vi		Chu vi
丼	Bát		Cái bát
善	Thiện	Cải thiện
繕	Thiện	Sửa chữa
協	Hiệp	Hiệp lực
脅	Hiếp	Ăn hiếp
脇	Hiếp	Cái nách
尊	Tôn		Tôn kính
遵	Tuân	Tuân lệnh
噂	Đồn		Tin đồn
度	Độ		Lần				
渡	Độ		Vượt qua		VƯỢT QUA THỦY ĐỘ
席	Tịch	Chỗ ngồi
導	Đạo		Chỉ đạo
賞	Thưởng	Tiền thưởng
償	Thường	Bồi thường
員	Viên	Nhân viên
損	Tổn		Tổn hại
韻	Vận		Vần điệu
憲	Hiến	Hiến pháp
徳	Đức		Đạo đức
聴	Thính	Thính giác
恥	Sỉ		Xấu hổ
鏡	Kính	Kính mắt
境	Cảnh	Cảnh giới
競	Cạnh	Cạnh tranh
敢	Cảm		Dũng cảm
厳	Nghiêm	Nghiêm túc
価	Giá		Giá trị
降	Giáng	Giáng chức
印	Ấn		Ấn tượng
栄	Vinh	Vinh quang
夢	Mộng	Giấc mơ
討	Thảo	Thảo luận
守	Thủ		Phòng thủ
団	Đoàn	Đoàn thể
狩	Thú		Săn bắt
封	Phong	Niêm phong
付	Phó		Giao phó
府	Phủ		Phủ huyện
符	Phù		Phù hiệu
腐	Hủ		Thối
附	Phụ		Thêm vào
采	Thái	Chỉ huy
菜	Thái	Rau
採	Thái	Hái
彩	Thái	Sắc thái
参	Tham	Tham gia
惨	Thảm	Bi thảm
修	Tu		Tu sửa
悠	Du		Ung dung
杉	Sam		Cây tùng
髪	Phát	Tóc
診	Chẩn	Chẩn đoán
珍	Trân	Quý hiếm
乳	Nhũ		Sữa
浮	Phù		Nổi lên
戻	Lệ		Quay lại		Mở CỬA TO để đón em LỆ QUAY LẠI
涙	Lệ		Nước mắt
旧	Cựu		Kỳ cựu
児	Nhi		Nhi đồng
陥	Hãm		Vây hãm
稲	Đạo		Bông lúa
単	Đơn		Đơn giản			Có 10 mẫu RUỘNG thì TỎA SÁNG ĐƠN GIẢN
弾	Đạn		Viên đạn			VIÊN ĐẠN ĐƠN GIẢN hơn CUNG tên
戦	Chiến	Chiến tranh
禅	Thiền	Thiền định
華	Hoa		Hoa mỹ
嘩	Hoa		Cãi nhau
果	Quả		Hoa quả
菓	Quả		Bánh kẹo
巣	Sào		Tổ chim
課	Khóa	Niên khóa
裸	Khỏa	Khỏa thân
彙	Vị		Nhiều loại
免	Miễn	Miễn tội
勉	Miễn	Miễn cưỡng
逸	Dật		Ẩn dật
防	Phòng	Phòng chống
房	Phòng	Căn phòng
訪	Phỏng	Phỏng vấn
両	Lưỡng	2 bên
満	Mãn		Mãn nguyện
岡	Cương	Sườn núi
剛	Cương	Cương cứng
鋼	Cương	Thép
綱	Cương	Dây thừng
尺	Xích	Đơn vị đo
駅	Dịch	Nhà ga
訳	Dịch	Phiên dịch
釈	Thích	Giải thích
沢	Trạch	Đầm lầy
択	Trạch	Tuyển dụng
街	Nhai	Đường phố
掛	Quải	Treo
佳	Giai	Giai nhân
崖	Nhai	Vách đá
涯	Nhai	Cuộc đời
堂	Đường	Võ đường
常	Thường	Bình thường
掌	Chưởng	Lòng bàn tay
賞	Thưởng	Tán thưởng
償	Thường	Bồi thường
可	Khả		Khả năng
河	Hà		Sông
何	Hà		Cái gì
荷	Hà		Hành lý
苛	Hà		Bắt nạt
司	Ty		Quản lý
伺	Tứ		Dò xét
飼	Tự		Nuôi
詞	Từ		Ca từ
嗣	Tự		Con cháu
同	Đồng	Đồng dạng
銅	Đồng	Chất đồng
胴	Đỗng	Cơ thể
筒	Đồng	Ống
洞	Động	Hang động
義	Nghĩa	Nghĩa khí
議	Nghị	Hội nghị
儀	Nghi	Lễ nghi
犠	Hi		Hi sinh
挙	Cử		Tuyển cử
誉	Dự		Danh dự
承	Thừa	Thừa nhận
即	Tức		Tức khắc
節	Tiết	Tiết kiệm
軍	Quân	Quân đội
輝	Huy		Huy hoàng
揮	Huy		Chỉ huy
陣	Trận	Trận địa
景	Cảnh	Phong cảnh
影	Ảnh		Cái bóng
憬	Cảnh	Cảnh tỉnh
久	Cửu		Vĩnh cửu
逆	Nghịch	Đối nghịch
志	Chí		Ý chí
誌	Chí		Tạp chí
恵	Huệ		Ân huệ
穂	Tuệ		Bông lúa
験	Nghiệm	Thí nghiệm
倹	Kiệm	Tiết kiệm
剣	Kiếm	Kiếm đạo
険	Hiểm	Nguy hiểm
検	Kiểm	Kiểm tra
建	Kiến	Kiến trúc
健	Kiện	Tráng kiện
鍵	Kiện	Chìa khóa
康	Khang	An khang
逮	Đãi		Đuổi bắt
兼	Kiêm	Kiêm nhiệm
謙	Khiêm	Khiêm tốn
廉	Liêm	Liêm khiết
鎌	Liêm	Cái liềm
嫌	Hiềm	Hiềm khích
残	Tàn		Tàn dư
桟	Sạn		Thanh gỗ
銭	Tiền	Tiền bạc
践	Tiễn	Thực tiễn
浅	Thiển	Nông cạn
巨	Cự		To lớn
距	Cự		Cự ly
拒	Cự		Cự tuyệt
臣	Thần	Đại thần
姫	Cơ		Công chúa
壊	Hoại	Phá hoại
懐	Hoài	Hoài niệm
環	Hoàn	Tuần hoàn
還	Hoàn	Hoàn trả
凍	Đông	Đông lạnh
棟	Đống	Nóc nhà
陳	Trần	Trần thuật
尼	Ni		Ni cô
泥	Nê		Bùn đất
成	Thành	Thành công
城	Thành	Thành lũy
誠	Thành	Thành thực
盛	Thịnh	Hưng thịnh
越	Việt	Vượt qua
松	Tùng	Cây thông
訟	Tụng	Kiện tụng
総	Tổng	Tổng hợp
焼	Thiêu	Thiêu đốt
暁	Hiểu	Bình minh
笑	Tiếu	Cười
妖	Yêu		Yêu quái
咲	Tiếu	Nở hoa
沃	Ốc		Rót tưới
粒	Lạp		Hạt nhỏ, hột