作	Tác		Tác giả
昨	Tạc		Hôm qua
酢	Tạc		Giấm ăn
搾	Trá		Ép
詐	Trá		Dối trá
索	Tác		Tìm kiếm
素	Tố		Yếu tố
麦	Mạch	Lúa mạch
算	Toán	Toán học
鼻	Tỵ		Cái mũi
合	Hợp		Hợp lý
拾	Thập	Thu thập
給	Cấp		Cung cấp
沿	Duyên	Men theo
鉛	Duyên	Chất chì
谷	Cốc		Thung lũng
浴	Dục		Tắm
欲	Dục		Dục vọng
俗	Tục		Phong tục
容	Dung	Bao dung
答	Đáp		Đáp án
塔	Tháp	Cái tháp
搭	Đáp		Đưa lên
溶	Dung	Dung dịch
液	Dịch	Dung dịch
折	Triết	Bẻ gập
哲	Triết	Triết học
斥	Xích	Bài xích
訴	Tố		Tố cáo
知	Tri		Tri thức
智	Trí		Trí tuệ
痴	Si		Si đần
疾	Tật		Bệnh tật
寺	Tự		Chùa
時	Thời	Thời gian
持	Trì		Duy trì
侍	Thị		Người hầu
詩	Thi		Thi ca
待	Đãi		Đợi
特	Đặc		Đặc biệt
等	Đẳng	Bình đẳng
得	Đắc		Đắc ý
自	Tự		Bản thân
息	Tức		Hơi thở
憩	Khế		Nghỉ ngơi
妻	Thê		Vợ
凄	Thê		Kinh khủng
周	Chu		Chu vi
週	Chu		Tuần
調	Điều	Điều hành
彫	Điêu	Điêu khắc
全	Toàn	Hoàn toàn
金	Kim		Vàng
栓	Xuyên	Then, chốt
去	Khứ		Quá khứ
至	Chí		Tột cùng
致	Trí		Nhất trí
到	Đáo		Đến nơi
倒	Đảo		Đổ
室	Thất	Phòng
窒	Trất	Chất đạm
屋	Ốc		Cao ốc
握	Ác		Cằm, nắm
事	Sự		Sự việc
律	Luật	Pháp luật
筆	Bút		Cái bút
書	Thư		Viết
津	Tân		Bến cảng
道	Đạo		Đường đi
導	Đạo		Chỉ đạo
易	Dịch	Buôn bán
賜	Tứ		Ban thưởng
物	Vật		Động vật
陽	Dương	Mặt trời
揚	Dương	Tuyên dương
瘍	Dương	Lở loét
場	Trường	Công trường
腸	Trường	Ruột
傷	Thương	Vết thương
湯	Thang	Nước nóng
色	Sắc		Màu sắc
絶	Tuyệt	Tuyệt đối
断	Đoạn	Đoạn tuyệt
継	Kế		Kế tục
台	Đài		Vũ đài
治	Trị		Trị liệu
始	Thủy	Bắt đầu
冶	Dã		Nấu chảy
初	Sơ		Sơ cấp
辺	Biên	Biên giới
切	Thiết	Cắt
窃	Thiết	Chộm cắp
刀	Đao		Con đao
刃	Nhẫn	Sắc, nhọn
忍	Nhẫn	Nhẫn nại
認	Nhận	Xác nhận
生	Sinh	Tiên sinh
星	Tinh	Ngôi sao
産	Sản		Sản nghiệp
牲	Sinh	Hy sinh
醒	Tỉnh	Tỉnh ngộ
晴	Tình	Trời nắng
情	Tình	Tình cảm
精	Tinh	Tinh luyện
晶	Tinh	Kết tinh
唱	Xướng	Ca xướng
飲	Ẩm		Uống
館	Quán	Hội quán
新	Tân		Mới
薪	Tân		Củi
良	Lương	Tốt
養	Dưỡng	Dinh dưỡng
長	Trường	Dài
張	Trương	Kéo dài			TRƯƠNG tam phong KÉO DÀI cái CUNG
帳	Trướng	Căng lên
多	Đa		Nhiều
移	Di		Di chuyển
土	Thổ		Đất
吐	Thố		Thổ ra
圧	Áp		Áp lực
泉	Tuyền	Suối
線	Tuyến	Tuyến đường
腺	Tuyến	Tuyến cơ thể
応	Ứng		Phản ứng
床	Sàng	Sàn nhà
麻	Ma		Cây lanh
且	Thả		Ngoài ra
祖	Tổ		Tổ tiên
組	Tổ		Tổ chức
租	Tô		Tô thuế
狙	Thư		Đích nhắm
粗	Thô		Thô bạo
宜	Nghi	Tiện nghi
査	Tra		Kiểm tra
畳	Điệp	Cái chiếu
助	Trợ		Trợ giúp
阻	Trở		Cản trở
島	Đảo		Hòn đảo
鳥	Điểu	Con chim
鶴	Hạc		Con hạc
鶏	Kê		Con gà
馬	Mã		Con ngựa
罵	Mạ		Lăng mạ
築	Trúc	Kiến trúc
恐	Khủng	Khủng hoảng
直	Trực	Trực tiếp
値	Trị		Giá trị
置	Trí		Đặt để			MẮT nhìn TRỰC tiếp trang TRÍ ĐẶT ĐỂ
植	Thực	Trồng cây
殖	Thực	Thực dân
具	Cụ		Công cụ
惧	Cụ		Sợ hãi
真	Chân	Chân thật
鎮	Trấn	Trấn áp
慎	Thận	Thận trọng
向	Hướng	Khuynh hướng
尚	Thượng	Hòa thượng
占	Chiếm	Chiếm lấy
粘	Niêm	Dính
貼	Thiếp	dán				Có TIỀN DÁN khắp nhà mới CHIẾM được THIẾP
米	Mễ		Gạo
迷	Mê		Bị lạc
謎	Mê		Câu đố
来	Lai		Tương lai
番	Phiên	Lần lượt
翻	Phiên	Phiên dịch
審	Thẩm	Thẩm phán
翌	Dực		Ngày mai
扇	Phiến	Cái quạt
毎	Mỗi		Mỗi ngày
侮	Vũ		Khinh thường
敏	Mẫn		Mẫn cảm
繁	Phồn	Phồn thịnh
毒	Độc		Độc dược
梅	Mai		Cây mơ
海	Hải		Biển
悔	Hối		Hối hận
研	Nghiên	Nghiên cứu
形	Hình	Hình dạng
刑	Hình	Hình phạt
型	Hình	Địa hình
歩	Bộ		Đường bộ
渉	Thiệp	Lịch thiệp
頻	Tần		Tần suất
枚	Mai		Đếm tờ giấy
牧	Mục		Mục sư
分	Phân	Phân chia
紛	Phân	Lộn xộn
粉	Phấn	Phấn hoa
雰	Phân	Bầu không khí
貧	Bần		Nghèo đói
盆	Bồn		Cái khay
方	Phương	Phương hướng
肪	Phương	Mỡ
坊	Phường	Phố phường
芳	Phương	Cỏ thơm
妨	Phương	Phương hại
紡	Phưởng	Dệt vải
未	Vị		Chưa đến
味	Vị		Hương vị
妹	Muội	Em gái
昧	Muội	Ngu muội
末	Mạt		Cuối cùng
抹	Mạt		Lau, quét
失	Thất	Thất bại
朱	Chu		Sắc đỏ
株	Chu		Cổ phần
殊	Thù		Đặc thù
珠	Châu	Châu báu
備	Bị		Chuẩn bị
集	Tập		Tập trung 
進	Tiến	Tiến bộ 
雑	Tạp		Tạp chí 
准	Chuẩn	Phê chuẩn 
準	Chuẩn	Chuẩn bị
推	Suy		Suy tính
唯	Duy		Duy nhất
維	Duy		Duy trì
誰	Thùy	Ai đó
稚	Trĩ		Thơ bé
羅	La		La bàn
観	Quan	Quan sát
権	Quyền	Quyền lợi
勧	Khuyến	Khuyến cáo
歓	Hoan	Hoan hỉ
確	Xác		Xác nhận
曜	Diệu	Ngày
躍	Dược	Nhảy
濯	Trạc	Tẩy, rửa
雇	Cố		Thuê
顧	Cố		Cố vấn
擁	Ủng		Ủng hộ
奮	Phấn	Hưng phấn
奪	Đoạt	Chiếm đoạt
隻	Chích	Đếm tàu
焦	Tiêu	Tiêu điểm
樵	Tiều	Tiều phu
礁	Tiều	Đá ngầm
亜	Á		Châu Á
悪	Ác		Ác nhân
要	Yếu		Tất yếu			PHỤ NỮ TÂY YẾU
腰	Yêu		Cái eo
煙	Yên		Khói
序	Tự		Thứ tự
預	Dự		Gửi
矛	Mâu		Mâu thuẫn
柔	Nhu		Mềm dẻo
務	Vụ		Nhiệm vụ
霧	Vụ		Sương mù
深	Thâm	Sâu
探	Thám	Thám hiểm		Trong ĐÊM CHÂN TAY chèo lên CÂY để THÁM HIỂM
芸	Nghệ	Nghệ thuật
伝	Truyền	Tuyên truyền
転	Chuyển	Chuyển động
雲	Vân		Mây
量	Lượng	Số lượng
糧	Lương	Lương thực
童	Đồng	Nhi đồng
瞳	Đồng	Đồng tử
鐘	Chung	Chuông
憧	Sung	Mong ước
友	Hữu		Bạn bè
抜	Bạt		Rút ra
有	Hữu		Có, tồn tại
納	Nạp		Nộp
柄	Bính	Cái chuôi
病	Bệnh	Bệnh tật
世	Thế		Thế giới
貰	Thế		Nhận lấy
菌	Khuẩn	Vi khuẩn
和	Hòa		Hòa bình
茹	Như		Luộc
葉	Diệp	Chiếc lá
喋	Điệp	Buôn chuyện
品	Phẩm	Sản phẩm
臨	Lâm		Lâm thời
器	Khí		Vũ khí
香	Hương	Hương thơm
季	Quý		Niên quý
委	Ủy		Ủy viên
萎	Nuy		Héo khô
育	Dục		Giáo dục
院	Viện	Bệnh viện
商	Thương	Thương phẩm
様	Dạng	Hình dạng
染	Nhiễm	Ô nhiễm
貝	Bối		Con sò
員	Viên	Nhân viên
買	Mãi		Mua
毛	Mao		Lông
尾	Vĩ		Đuôi
安	An		An toàn
案	Án		Đề án
条	Điều	Điều kiện
猛	Mãnh	Mãnh liệt
塩	Diêm	Muối
貴	Quý		Quý tộc
遺	Di		Di chúc
潰	Hội		Nghiền nát
遣	Khiển	Cử đi
氷	Băng	Nước đá
永	Vĩnh	Vĩnh cửu
泳	Vịnh	Bơi
詠	Vịnh	Làm thơ
尿	Niệu	Tiết niệu
桜	Anh		Anh đào
傍	Bàng	Bên cạnh
接	Tiếp	Trực tiếp
拝	Bái		Khấn bái
拓	Thác	Khai thác
央	Ương	Trung ương
英	Anh		Tiếng anh
映	Ánh		Phản ánh
温	Ôn		Ôn hòa
寒	Hàn		Lạnh
呈	Trình	Thuyết trình
程	Trình	Trình độ
聖	Thánh	Thần thánh
皇	Hoàng	Hoàng đế
介	Giới	Giới thiệu
界	Giới	Thế giới
届	Giới	Gửi đến
戒	Giới	Cảnh giới
械	Giới	Cơ giới
皆	Giai	Mọi người
階	Giai	Giai cấp
諧	Hài		Hài hòa
陛	Bệ		Bệ hạ
昆	Côn		Côn trùng
混	Hỗn		Hỗn loạn
漢	Hán		Hán tự
難	Nan		Gian nan
嘆	Thán	Ca thán
減	Giảm	Giảm xuống
感	Cảm		Cảm giác
憾	Hám		Đáng tiếc
域	Vực		Khu vực
惑	Hoặc	Mê hoặc
館	Quán	Hội quán
官	Quan	Quan lại
管	Quản	Quản lý
棺	Quan	Quan tài
追	Truy	Truy đuổi
期	Kì		Kì hạn
旗	Kì		Lá cờ
碁	Kì		Cờ vây
棋	Kì		Cờ tướng
欺	Khi		Lừa đảo
名	Danh	Tên
各	Các		Các vị
客	Khách	Khách hàng
格	Cách	Tính cách
額	Ngạch	Kim ngạch
落	Lạc		Rơi xuống		Cô THẢO đẩy CÁC VỊ rơi xuống NƯỚC
絡	Lạc		Liên lạc
酪	Lạc		Bơ lạc
閣	Các		Nội các
略	Lược	Chiến lược
急	Cấp		Khẩn cấp
及	Cập		Phổ cập
級	Cấp		Cấp độ
吸	Hấp		Hô hấp			MỒM PHỔ CẬP HÔ HẤP
扱	Tráp	Đối xử
呂	Lữ		Bồn tắm
侶	Lữ		Bầu bạn
宮	Cung	Cung điện
営	Doanh	Kinh doanh
去	Khứ		Quá khứ
法	Pháp	Phương pháp
却	Khước	Khước từ
脚	Cước	Cú đá
柿	Thị		Cây hồng
肺	Phế		Phổi
君	Quân	Em
群	Quần	Quần đảo
郡	Quận	Quận huyện
曲	Khúc	Ca khúc
典	Điển	Từ điển
農	Nông	Nông nghiệp
濃	Nồng	Đậm
豊	Phong	Phong phú
艶	Diễm	Diễm lệ
無	Vô		Vô lý
舞	Vũ		Khiêu vũ
共	Cộng	Công cộng
洪	Hồng	Hồng thủy
港	Cảng	Hải cảng
恭	Cung	Cung kính
供	Cung	Cung cấp
異	Dị		Khác thường
糞	Phẩn	Phân
翼	Dực		Cái cánh
展	Triển	Phát triển
添	Thiêm	Thêm vào
蒸	Chưng	Chưng cất
与	Dự		Ban cho
写	Tả		Tả lại
号	Hiệu	Số hiệu
朽	Hủ		Mục nát
巧	Xảo		Tinh xảo
汚	Ô		Ô nhiễm
誇	Khoa	Khoa trương
顎	Ngạc	Cái cằm
旨	Chỉ		Chỉ dụ
指	Chỉ		Ngón tay
脂	Chi		Mỡ
詣	Nghệ	Lễ chùa đầu năm
稽	Kê		Khấu đầu
束	Thúc	Bó, buộc
速	Tốc		Tốc độ
疎	Sơ		Sơ sài
刺	Thích	Đâm chích
策	Sách	Sách lược
区	Khu		Khu vực
駆	Khu		Tiến đến
欧	Âu		Châu âu
殴	Ẩu		Ẩu đả
存	Tồn		Tồn tại
在	Tại		Tồn tại
実	Thực	Thực sự
美	Mỹ		Đẹp
業	Nghiệp	Nông nghiệp
僕	Bộc		Xưng tôi
撲	Phác	Đánh nhau
求	Cầu		Yêu cầu
球	Cầu		Địa cầu
救	Cứu		Cấp cứu
后	Hậu		Hoàng hậu
局	Cục		Cục bộ
厚	Hậu		Bề dày
利	Lợi		Tiện lợi
痢	Lị		Bệnh lị
梨	Lê		Quả lê
斉	Tề		Chỉnh tề
済	Tế		Kinh tế
剤	Tễ		Dịch tễ
歯	Xỉ		Răng
奥	Áo		Trong cùng
菊	Cúc		Hoa cúc
粛	Túc		Nghiêm túc
決	Quyết	Quyết định
快	Khoái	Khoái thích
県	Huyện	Tỉnh
懸	Huyền	Cố gắng
命	Mệnh	Sinh mệnh
軽	Khinh	Khinh nhẹ
経	Kinh	Kinh tế
径	Kính	Đường kính
怪	Quái	Ma quái
茎	Hành	Cái cuống
辛	Tân		Cay
宰	Tể		Tể tướng
辞	Từ		Từ điển
卒	Tốt		Tốt nghiệp
率	Suất	Năng suất
幸	Hạnh	Hạnh phúc
執	Chấp	Chấp hành
達	Đạt		Thành đạt
軌	Quỹ		Quỹ đạo
摯	Chí		Mạnh mẽ
示	Thị		Chỉ thị
宗	Tông	Tôn giáo
踪	Tung	Biến đi
崇	Sùng	Sùng bái
奈	Nại		Tận cùng
祭	Tế		Lễ hội
際	Tế		Quốc tế
察	Sát		Cảnh sát
擦	Sát		Ma sát
斎	Trai	Ăn chay
史	Sử		Lịch sử
吏	Lại		Quan lại
使	Sử		Sử dụng			NGƯỜI ĐỨNG kể LẠI cách SỬ DỤNG
身	Thân	Bản thân
射	Xạ		Bắn
謝	Tạ		Cảm tạ
更	Canh	Đổi mới
硬	Ngạnh	Ương ngạnh
梗	Ngạnh	Tắc nghẽn
便	Tiện	Tiện lợi
取	Thủ		Lấy				THỦ lại LẤY mất TAI
趣	Thú		Hứng thú
獣	Thú		Thú vật
最	Tối		Tối cao			LẤY được MẶT TRỜI thì có sức mạnh TỐI CAO
撮	Toát	Chụp ảnh		TỐI KỊ khi CHỤP ẢNH là TAY TOÁT mồ hôi